27
16
SSSSSSSSSSSSSSSSSSSSSSSSSSS
>.........................<
>.........................<
>.........................<
{h.......................h}
(HT........c.............H)
##########......###########
>f........................<
>.......................T.<
###......#########......###
>.c.......................<
>...T.....................<
##########...P...##########
{h....F..................h}
(H..M.................L..H)
###########################