27
16
SSSSSSSSSSSSSSSSSSSSSSSSSSS
>.........................<
>.........................<
>.........................<
{h.......................h}
(H....g....c...........g.H)
##########......###########
>f........................<
>.........................<
###......#########......###
>.........................<
>...g.....................<
##########...P...##########
{h.......................h}
(H..MF................L..H)
###########################